TTTT.............MMM
TTT...............MM
TT.....RRRRR.......M
......RR...RR.......
.....RR.....RR......
.....R.......RR..MM.
.....R..MM....R..MM.
.HRRRR..MM....R.....
.....R........RRRRH.
.....R........R.....
.....RR......RR.....
......RR....RR......
.......RRRRRR.......
....................
.TT...........MMM...
.T.............MM...
MM..................
MM.......TT.........
.........TTT....MM..
..........T.....MMM.